en-development-0001	Wakes your brain up!	comment
en-development-0002	The location is perfect with Marais being a great area to stay in with restaurants, shops, cafes, bars and the metro all close by.	comment
en-development-0003	Despite the noise and bustle outside, the rooms are very quiet, and we overlooked Las Ramblas.	comment
en-development-0004	We travel often and usually stay at very nice hotels.	comment
en-development-0005	This was so bad experience that i wouln't stay again in this hotel.	complaint
en-development-0006	So fast.	comment
en-development-0007	I am unsure as to whether or not the creators are also reading private dms.	comment
en-development-0008	FC5CBFO, on checking this out all antiviruses say the same thing about this program.	comment
en-development-0009	The room was clean, quite, black out windows for siesta.	comment
en-development-0010	This downloader is great.	comment
en-development-0011	When you take some time using it you realize it is a great video editing.	comment
en-development-0012	All manner of conveniences are available "barring" a mini-bar (pun intended :) ).	comment
en-development-0013	Basically, it's an ok planner.	comment
en-development-0014	Takes my mind notes visually and understandable.	comment
en-development-0015	Very disappointing.	complaint
en-development-0016	Nice breakfast, complimentary mini bar in room, safe for your belongings, toiletries.	comment
en-development-0017	Even the accessories in the app look fake.	complaint
en-development-0018	I don't what Microsoft was thinking with this update but I don't like it either way~	complaint
en-development-0019	To much muscito's.	complaint
en-development-0020	Can't find anything on oracle about windows 2000 not being supported and this page lists windows 2000 as supported, but the x86 downloads for jre7 all result in not a valid win32 application messages.	complaint
en-development-0021	I would liked a complete bathroom with the wash basin in the same room.	complaint
en-development-0022	Brilliant for Energy Assessors to compile photo evidence for audits.	comment
en-development-0023	Breakfast is just soso.	complaint
en-development-0024	* Feature-Packed	comment
en-development-0025	) and the breakfast was really good and the view and walking facilities for the dog in the grounds were terrific.	comment
en-development-0026	When you phone the staff say parking is around the corner.	meaningless
en-development-0027	The wether as you understand in Russia was extremely cold, but the heating system was extra hot and we couldn't control it at all.	complaint
en-development-0028	4. THERE ARE NO CHEATERS ON THAT GAME OR HACKERS	comment
en-development-0029	The hotel is very nice, modern, clean.	comment
en-development-0030	There were 4 responsible during our visit;but this lady gave us our room earlier than check-in time;but she was very rude and her attitudes were very bad..	complaint
en-development-0031	Being a new Apple Developer, I needed a fast program that would work fast and has a easy User Interface.	request
en-development-0032	Won't recommend it to anyone.	comment
en-development-0033	excited	comment
en-development-0034	Reserved a suite for four nights and requested a room on a higher floor with a view of the square in front.	comment
en-development-0035	The people who gave it 5 or 4 or 3 or 2 stars.	meaningless
en-development-0036	When checking out, they even put wrong charge from other room onto our bill, wasting our time, 30 mins,for waiting them to check and revise the bill, sooooooo slow.	complaint
en-development-0037	Full of ads!	complaint
en-development-0038	This is good.	comment
en-development-0039	Feels like Skype hired the same person who ruined hangout :/	complaint
en-development-0040	Bedroom excellent,staff impeccable,the manager on the night we stayed was a man called [NAME] who was the friendliest manager iv ever know,very nice place very nice people.	comment
en-development-0041	I went to another hotel down the road who still had an open restaurant.	meaningless
en-development-0042	Wonderful staff at breakfast nothing too much trouble.	comment
en-development-0043	And All-Inclusive choice could be good.	request
en-development-0044	Free wifi is compromised and actually blacklisted on 3 counts on IP information site.	complaint
en-development-0045	But seriously, this game is cool.	comment
en-development-0046	This hotel has so much to offer and is brilliantly located for all of the hot spots in Barcelona.	comment
en-development-0047	The staff was better than fantastic.	comment
en-development-0048	Please make it stop.	complaint
en-development-0049	This is a really fun game to play in your spare time.	comment
en-development-0050	Most of the people I know have this game downloaded to their phone, tablet, or computer.	comment
en-development-0051	Just awesome.	comment
en-development-0052	The Daum Pot Player has the potential to be a very good video player.	comment
en-development-0053	Listen to the people who gave it 1 star.	complaint
en-development-0054	It was great.	comment
en-development-0055	Beyond thrilled and thoroughly addicted!	comment
en-development-0056	Hotel very nice and staff very helpful and friendly.	comment
en-development-0057	I loaded it onto my Windows 7 machine and hide a store of files.	comment
en-development-0058	This hotel is gorgeous and pretty spacious.	comment
en-development-0059	A bit misleading, I thought I was booking a hotel for $389.00 everything in.....then it said $453.00 taxes & hotel fees!	complaint
en-development-0060	Have stayed here a couple of times and each time it's been perfect!	comment
en-development-0061	Having the wash basin in the room made it a little difficult.	complaint
en-development-0062	Totally free and totally worth it.	comment
en-development-0063	Spring Spa Escape was fantastic value.	comment
en-development-0064	Hotel was one of our favorites.	comment
en-development-0065	The rooftop pool is amazing.	comment
en-development-0066	Our room was on the upper floor with a view of the Eiffel Tower.	comment
en-development-0067	The room had issues with cleanliness, and maintenance.	complaint
en-development-0068	We also walked further down to the Zocalo and to the cathedral.	meaningless
en-development-0069	even if they are planning to renovate the old section in the near future, it would be nice if they kept up with simple maintenance issues - like replacing the missing tiles from the stairs etc..	request
en-development-0070	The best game boy ever	comment
en-development-0071	Limited options	complaint
en-development-0072	We couldn't have been happier with the hotel.	comment
en-development-0073	Wow, this hotel is top notch and it's location in the Gothic Quarter is great.	comment
en-development-0074	Although I do kind've dislike the fact on how you have to put your actual face on here.	complaint
en-development-0075	The Corner Hotel has a beautiful aesthetic.	comment
en-development-0076	There wasn't any program in the late evening	complaint
en-development-0077	this place is different!	comment
en-development-0078	Helpful staff and mini fridge in the room stocked with sofa, juice and water.	comment
en-development-0079	The slow service and understanding appears to be a "thing" among the Balenese people.	comment
en-development-0080	If I want to use the bloody Snapchat I'll download that on my phone.	complaint
en-development-0081	Rte is essentially a quango and this is the product of an over fattened civil servant pig.	complaint
en-development-0082	Air Con when it works does not suit all people.	complaint
en-development-0083	Also I think it needs more hairstyles I have ombre hair that should be an option.	request
en-development-0084	Plus, lots of graphical lag when trying to show new messages.	bug
en-development-0085	Great room and shower.	comment
en-development-0086	Old, but stable game.	comment, complaint
en-development-0087	Phone froze as if the app had a virus.	bug
en-development-0088	These issues need to be resolved.	comment
en-development-0089	Worked fast and excellently on a number of jpegs for emailing purposes, reduced file size by 98% with no loss of readability.	comment
en-development-0090	Upgrade to a suite - it's so worth the extra luxury.	comment
en-development-0091	* Very dull output picture Quality.	complaint
en-development-0092	only complaint is it drains the battery pretty fast, but all app games drain the battery.	complaint
en-development-0093	Many thanks to the wonderful staff at the hotel but especially [name] and his colleague [name] who did everything to ensure we were well informed about Paris.	comment
en-development-0094	Thanks!	comment
en-development-0095	We ordered three of the same thing from the menu we were given but the server delivered something totally different.	complaint
en-development-0096	Works straight out of the box	comment
en-development-0097	When you order something in the restaurant it takes long time to get it and they always miss something.	complaint
en-development-0098	A charming hotel in a peaceful part of the city, yet many shops, restaurants and coffee shops close by.	comment
en-development-0099	The same thing happened the next morning.	meaningless
en-development-0100	THe Demo is only one hour!	complaint
en-development-0101	This chain overbooked for our stay so we arrived at a sister hotel after 8 hours on the road to be told we were bumped to another nearby.	complaint
en-development-0102	One of our good friends was staying a few doors down from us and received a plate of macarons on their first night and each consecutive night after.	comment
en-development-0103	The room was facing an inner garden, facing windows of other rooms, it could have been anywhere, not mentioned at booking.	complaint
en-development-0104	It is one of the best hotels that I have encountered.	comment
en-development-0105	The room was very small but the way it is furnished creates so much space for everything.	comment
en-development-0106	i think is sow cool	comment
en-development-0107	A dont have original program, but number 17 is inafe good and more then everybody need.	comment
en-development-0108	Friendly Staff, Comfortable room, excellent breakfast.	comment
en-development-0109	i think the google earth is wonderful!	comment
en-development-0110	It is a huge step into the past, it isn't good at all.	complaint
en-development-0111	I was really impressed with this hotel.	comment
en-development-0112	The restaurant is a true dining experience - outstanding food and service.	comment
en-development-0113	install this and windows 10 will update it to a newer version	comment
en-development-0114	I have to see them individually.	meaningless
en-development-0115	I liked the staff, they were very friendly and helpful.	comment
en-development-0116	I don't want to see "Translate from hindi" in the bottom as suggestion when I'm translating from Marathi.	complaint
en-development-0117	You will face awful dirt and noise everywhere they are.	complaint
en-development-0118	Great hotel and fantastic staff.	comment
en-development-0119	We would definitely stay there again!	comment
en-development-0120	Bedroom was big and bed very comfortable.	comment
en-development-0121	We enjoy the view from our suite, very clean and excellent organized.	comment
en-development-0122	5 stars!	comment
en-development-0123	Piano Tiles 2 is a great game, really fun to play and you won't find yourself deleting it after only a few days or weeks.	comment
en-development-0124	if there any updates?	request
en-development-0125	It was not very clean,strong smell of paint on the third floor, and had to access third floor from second floor up stairs because of ongoing reovations.	complaint
en-development-0126	But it did not!	meaningless
en-development-0127	awesome app	comment
en-development-0128	Water pressure of the shower is weak.	complaint
en-development-0129	Instagram doesn't remember the Facebook share settings.	bug
en-development-0130	It is having a huge impact on comfort in this generally good hotel	meaningless
en-development-0131	I can't stop playing this game even my little brother plays it and he is 5 years old.	comment
en-development-0132	We enjoyed our stay very much.	comment
en-development-0133	A high price for guests to access pool facilities, we just wanted a quick dip, not an afternoon spa experience.	complaint
en-development-0134	Water in shower smelt, the pool on the beach was closed and thats why we chose the resort but we didn't find this information out until we arrived - very very disappointed with that as wouldn't have stayed there if we knew that was the case.	complaint
en-development-0135	Cons:	meaningless
en-development-0136	The room was located at the end of a very long hall and the mattress was extremely uncomfortable.	complaint
en-development-0137	Htc sync is a bad problem for htc owners.	complaint
en-development-0138	New smileys look so flat and boring.	complaint
en-development-0139	Restaurant - breakfast - very simple bufet, the worst coffe we ever drink, poor staff in the restaurant	complaint
en-development-0140	I also like the different things you can use to send to friends.	comment
en-development-0141	Nothing	meaningless
en-development-0142	They don t have parking	complaint
en-development-0143	It will on ly vug you to the limits of your time.	meaningless
en-development-0144	It has become rather addicting for my mother and I and we can never get enough of it.	comment
en-development-0145	I play the classics on this game more than I do on my actual piano!	comment
en-development-0146	Beautifully crafted resort.	comment
en-development-0147	The staff are exceptionally friendly and attentive.	comment
en-development-0148	We held welcome drinks at the pool bar the night before our wedding.	comment
en-development-0149	loved using it	comment
en-development-0150	1. Service Tax = 12% of amount	meaningless
en-development-0151	We spent the last 3 days of our vacation in Barcelona.	comment
en-development-0152	I finally got the game in win 8.1. I like this game very much.	comment
en-development-0153	No mouse control.	complaint
en-development-0154	The hotel was clean, well managed, conveniently located and the staff was outstanding.	comment
en-development-0155	The twin room was small in size, perfect for 1or2 night stay.	comment
en-development-0156	As the men have more things that appeal to girls.	meaningless
en-development-0157	how can it be solved???	request
en-development-0158	Very helpful.	comment
en-development-0159	The rooms are very modern and cool with all the amenities you expect from this level of hotel.	comment
en-development-0160	The installing process was quite complicated.	complaint
en-development-0161	Residents had to eat breakfast in the restaurant and couldn't sit outside on the square.	complaint
en-development-0162	Ocean wasn't good for swimming	complaint
en-development-0163	Does not do what it claims to do.	complaint
en-development-0164	Spent a long time selecting the right hotel for a 3 night break to Barcelona.	meaningless
en-development-0165	it is so wonderful to use	comment
en-development-0166	I do not know who is on-line and who is not, if I am on the contact list.	bug
en-development-0167	I loved the big sink and mirror in the bathroom and the spaciousness of the room.	comment
en-development-0168	It was sheer chaos when I arrived.	complaint
en-development-0169	Not good.	complaint
en-development-0170	Couldn't fault the place!	comment
en-development-0171	It is impossible to give this hotel the reviews it deserves in words.	comment
en-development-0172	Teracopy really rocks and works well with Windows Explorer, but does not seem to work with v8.5	comment, complaint
en-development-0173	Great service, great views, the rooms were clean and comfortable.	comment
en-development-0174	We stayed here for 2nights when we visited Barcelona, what a great hotel!	comment
en-development-0175	Thank you hotel Imperial!!!!!!!	comment
en-development-0176	other than that its a realllly cool app	comment
en-development-0177	Not cool, so bad review so their marketing team thinks about it.	complaint
en-development-0178	No errors.	comment
en-development-0179	I'd give it a minus if I could.	complaint
en-development-0180	I was told on the site that u don't pay til check in (like before) and two days later the entire amount of$251.37 was taken from my bank card.	complaint, bug
en-development-0181	room was nice and big and comfortable	comment
en-development-0182	it bis so helpful for find Age .	comment
en-development-0183	ah software ke throuhg maine apna keemti data recovr kiya hai	meaningless
en-development-0184	Its a lovely place made even more memorable by an excellent team of staff.	comment
en-development-0185	I love my Songbird & listen to	meaningless
en-development-0186	2. It's nothing but it consumes a large amount a CPU and memory.	complaint, bug
en-development-0187	an unexpected error has occured.	complaint
en-development-0188	Unless one of them DIES (rip lightbulb you will be missed ;-; )	undefined
en-development-0189	Very low level of service.	complaint
en-development-0190	Then started to ramble on about the the hotel architecture.	meaningless
en-development-0191	it's a boutique hotel,	comment
en-development-0192	is literally the WORST web browser that I have ever used in my entire life.	complaint
en-development-0193	Really good palyer.	comment
en-development-0194	You can get a lot of different registry correcting software, but this one really fixes the problems and you don't have to worry about it damaging your system unlike other software.	comment
en-development-0195	It has several settings to uninstall and scan for unnecessary and excess files and other useless files, folders etc.	complaint
en-development-0196	Clean!	comment
en-development-0197	Only restriction applies to t-shirts with alcohol brands.	comment
en-development-0198	Five star prices but that's about it.	complaint
en-development-0199	We would highly recommend this Hotel.	comment
en-development-0200	Good triple rooms, comfy beds and plenty of space.	comment
en-development-0201	I would say that the parking area is a little too far, since we brought a private car with no driver.	complaint
en-development-0202	Also the themes should at least have one that was similar to the previous blue and grey look.	request
en-development-0203	I am FURIOUS!	complaint
en-development-0204	easy to use	comment
en-development-0205	it has solved a huge problem to me .	comment
en-development-0206	Nobody proposed anything how to solve my problem.	complaint
en-development-0207	Anybody have any ideas how to fix this problem.	request
en-development-0208	We absolutely loved our stay at the Saint James, Paris.	comment
en-development-0209	Very warm welcome at the reception by Valentin.	comment
en-development-0210	[name] went out of her way to help us.	comment
en-development-0211	The one weights machine was only partly working.	complaint
en-development-0212	game is good	comment
en-development-0213	Looks just the pictures with two patio doors and balcony.	comment
en-development-0214	rooms were clean and big.	comment
en-development-0215	Stayed at a very bad hotel that was a dump recently.	meaningless
en-development-0216	- Easy to Use	comment
en-development-0217	This is a lovely gem of a small boutique hotel.	comment
en-development-0218	Good and faster.	comment
en-development-0219	Hello everyone I used VanBasco Karaoke Player on my previous laptop under window XP	comment
en-development-0220	My husband talked to one of the staff at the front desk to see if they would have any luck getting through to the restaurant.	meaningless
en-development-0221	Beds most comfortable thing ever	comment
en-development-0222	Discount codes and deals absolutly never work.	complaint
en-development-0223	Repaintet room and new tiles in the bathroom.	comment
en-development-0224	the charcter	meaningless
en-development-0225	I only have one complaint, which is the lack of any modern songs.	complaint, request
en-development-0226	audio and video is good	comment
en-development-0227	I had to pull out the battery and restart.	complaint
en-development-0228	I was surprised to see a separate gluten-free section in the buffet area of the diningroom for breakfast - there was a good selection of cereals, bread,	comment
en-development-0229	It's a perfect location for exploring the vibrant neighborhood, as well as the Notre Dame, Louvre, etc.	comment
en-development-0230	The curtain of the bathroom had some marks that we didn't like to touch.	complaint
en-development-0231	This is a warning about Camfrog	meaningless
en-development-0232	I wish Booking wouldn't represent certain hotels.	complaint
en-development-0233	The room was swell with a mini fridge, excellent bathroom with molten brown products, yummy breakfasts included, great location, nice roof top area.	comment
en-development-0234	Otherwise very happy and continue to use it.	comment
en-development-0235	Very simple to use.	comment
en-development-0236	I have stayed at many boutique hotels and this one went above and beyond in terms of service.	comment
en-development-0237	Huge Ryanair fan and 9 times out of 10 they are the cheapest but cmon!	comment
en-development-0238	I've analyzed the the Sonic Games program file with virustotal.com,and the final score was 0/41. That means a 0% presence of viruses, trojans or any other threat in this file.	comment
en-development-0239	We could not have stayed at a nicer hotel in Paris.	comment
en-development-0240	This hotel was the perfect location to escape the hustle and bustle of the city and was lovely to come back to after a day out exploring.	comment
en-development-0241	You don't need to spend money, and you can play it at your own pace.	comment
en-development-0242	Extraordinary choices, i always want more.	meaningless
en-development-0243	yes i want to test , it's look funny!!	comment
en-development-0244	Nothing	meaningless
en-development-0245	By far the best efective filter for web that I used.	comment
en-development-0246	They couldn't understand anything we were asking.	complaint
en-development-0247	If the hotel transport to and from airport can be provided for free than the flow of the trip would have been much better.	request
en-development-0248	But there is one limitation for users like India.	complaint
en-development-0249	This room was booked at the last minute due to having to leave our previous hotel early due to unsuitability.	meaningless
en-development-0250	program i like create game like a hl2,portal 2,lf4d2,hl and	comment
en-development-0251	realy good	comment
en-development-0252	A beautiful river runs by near the location.	comment
en-development-0253	Very very nice program	comment
en-development-0254	Stayed here this month before a cruise.	meaningless
en-development-0255	I really hate the new version!	complaint
en-development-0256	The new Skype update, to summarize, is a major setback, and does indeed provide features the original didn't have, but it shouldn't be an issue to keep the prior version and add in new aspects.	complaint
en-development-0257	wow wow wow wow wow wow	comment
en-development-0258	Nothing	meaningless
en-development-0259	Your real IP is leaked on HTTPS sites without you knowing.	complaint
en-development-0260	We had a great four night stay at la Chambre du Marais.	comment
en-development-0261	Bed was very comfy.	comment
en-development-0262	I was supposed to receive it by 04/24/17 which was later changed to 05/03/17. So I contacted support letting them know before May 3rd that i moved and that my package was still was not there even after checking after May 3rd.	complaint
en-development-0263	There is also a castle that you can hike to.	comment
en-development-0264	The style of the hotel is very pretty in a chic kind of way.	comment
en-development-0265	This app is not good.	complaint
en-development-0266	Located in a beautiful residential arrondissement in walking distance to L'Arc de Triumphe.	comment
en-development-0267	Plus the videos don't load until we restart the app	bug
en-development-0268	Doesn't see my phone - cant do anything with it	complaint
en-development-0269	I rang reception at 21:30 to notify them of the noise.	comment
en-development-0270	[name] (tall [name] with little hair) was so kind, friendly and helpful.	comment
en-development-0271	Many young generation in the entourage.	comment
en-development-0272	Number of good add-ons is limited	complaint
en-development-0273	I would stay there again, it was a perfect experience.	comment
en-development-0274	The hotel is old and definitely in need of an upgrade, particularly given the prices charged.	complaint
en-development-0275	Staff were wonderful.	comment
en-development-0276	Watching my tv shows should not be this difficult.	complaint
en-development-0277	great app	comment
en-development-0278	One thing I do not like is Charizard.	comment
en-development-0279	I knew I was in the right place when I heard them playing it in the lobby.	meaningless
en-development-0280	I was was able to configure my HL-2240 Brother printer, and my old HP scanner was immediately recognized.	comment
en-development-0281	I love it!	comment
en-development-0282	Great place to stay on the left bank.	comment
en-development-0283	(saving the hazzle of dealing with local taxi company ripping people off, or having many taxi drivers harassing you when u walk out- which is our only problem for this trip.)	complaint
en-development-0284	It is across the river and a long walk in the rain to get there and back.	complaint
en-development-0285	Rooms were a bit pricey though.	complaint
en-development-0286	Noisy cleaning and lot's of fumes at 5am.	complaint
en-development-0287	Very cool personalizing your own character.	comment
en-development-0288	Close to a mall and food places.	comment
en-development-0289	We had an incredible four day stay at the Peninsula!	comment
en-development-0290	Over the years have stayed 20 - 30 times at this Hotel	comment
en-development-0291	The towel i used was stained and ragged.	complaint
en-development-0292	Hotel was clean and food was awesome...	comment
en-development-0293	Can't share photos straight from the gallery app.	bug
en-development-0294	La Chambre du Marais is a recently renovated boutique hotel in the Marais section of Paris.	comment
en-development-0295	Service was appaling - absolutely not up to Sofitel standards.	complaint
en-development-0296	it is so much easier to use my in come is thru the A.	meaningless
en-development-0297	She followed up with a call to my room to make sure everything was to my satisfaction.	comment
en-development-0298	It's more like a tommogatchi kind of game, where you feed and train your Magikarp to "Battle" or jump.	comment
en-development-0299	This is the only hotel we have stayed in that we had to pay for parking.	complaint
en-development-0300	The ads that run have no video just audio, and then get stuck so I have to repeat over and over getting it to load my content.	bug, complaint
en-development-0301	-Staff was genuinely friendly and helpful.	comment
en-development-0302	The tour ended at the Barcelona Hilton, but we wanted someplace closer to the sights so we moved to the Catalonia Square.	meaningless
en-development-0303	The room was small with no view, but we didn't care as we were there to see the city.	comment
en-development-0304	this is the best media player because of following:	meaningless
en-development-0305	A very nice and clean hotel.	comment
en-development-0306	My wife and I spent three nights here after a group tour of Northern Spain.	meaningless
en-development-0307	-is free	comment
en-development-0308	There is nothing to dislike at the Oberoi.	comment
en-development-0309	Great location and very helpful and professional staff.	comment
en-development-0310	I went to uninstall it and it won't uninstall.	bug
en-development-0311	Everything at your doorstep.	comment
en-development-0312	Overall excellent.	comment
en-development-0313	Picture quality.	meaningless
en-development-0314	I have been using	meaningless
en-development-0315	Even a yoga class ...	meaningless
en-development-0316	Totally brilliant intuitive application.	comment
en-development-0317	I stayed in a Deluxe Boulevard room for 3 nights as part of a large corporate group.	comment
en-development-0318	The most comfortable hotel bed we have ever slept in!	comment
en-development-0319	The lobby doesn't exist currently, as it's under construction.	complaint
en-development-0320	I didnt like that we were given a room in the far flung corner of the resort up on Level 3. I didnt like that the pool and restaurant on the beach was under construction (would not have booked here if I knew). I didnt like the breakfast much, pretty ordinary and the noise of the construction was a bit off putting.	complaint
en-development-0321	I give this company credit for using pictures/images that are clear in interpretation, which makes the game much more enjoyable.	comment
en-development-0322	Because my account is so old, I have no way of accessing the original email address I used to opem it Now it is telling me it can't verify who I am!!!	bug
en-development-0323	Delightful I know.	comment
en-development-0324	We just returned from our 6 night stay at the Hotel Monge.	meaningless
en-development-0325	I will be sure to bookmark your blog and may come back very soon.	comment
en-development-0326	Plz send me this software because i forgotten it.	request
en-development-0327	We mistakenly had thought we had all rooms booked for 2 nights but we only had one night booked.	comment
en-development-0328	Maybe old style clothing too from civil war era not just city slicker clothing	undefined
en-development-0329	its a fabulous games	comment
en-development-0330	Can't complain at the Beach front location!	comment
en-development-0331	Thanks for that.	comment
en-development-0332	Very expensive for an 'ok' room.	complaint
en-development-0333	When we ask ice water they bring either water or ice not together.	complaint
en-development-0334	Very good software for free user..	comment
en-development-0335	its good	comment
en-development-0336	I have watched soaps on this a few times.	comment
en-development-0337	We stayed a couple of nights at Favart.	comment
en-development-0338	It was very hot in the room.	complaint
en-development-0339	it is best app	comment
en-development-0340	Came to the area to visit a local Asian Festival & the Columbus Zoo.	meaningless
en-development-0341	Whatever you request they get it done.	comment
en-development-0342	I hope this helps u rate the game.	meaningless
en-development-0343	itworks great on skype to.	comment
en-development-0344	Castle Crashers was a very far fetched at first for me.	comment
en-development-0345	Okay, I seen people use Bitmoji and I was all like you know what I'm gonna give it a shot and yeah so it was really good and in fact maybe I can get my Bitmoji character to be friends with a unique character by EnhancedToon "Sunny the Yellow Creature" so yeah.	comment
en-development-0346	Every time you try to watch a live stream, the stream is hijacked by a mandatory unskippable advert.	complaint
en-development-0347	All the different colors and settings satisfy me greatly.	comment
en-development-0348	a) It's very creative (Sandbox game) as you can move and place back almost every little object in the huge world.	comment
en-development-0349	Close to restaurants, hop on and off bus and the Metro.	comment
en-development-0350	It's free, no ads, no hidden pay-to-play content, it even limits how much money you can put into it!	comment
en-development-0351	really dislike it.	complaint
en-development-0352	Jesus!	complaint
en-development-0353	It's there and configured but won't pop up.	complaint
en-development-0354	The location is second to none - my husband and I walked everywhere as the location was so central and in the centre of everything.	comment
en-development-0355	Unfortunately the bed was so hard and uncomfortable we didn't have this problem last time we stayed so maybe just unlucky with the bed in this room we got but it made sleeping very difficult.	complaint
en-development-0356	This program is very useful!	comment
en-development-0357	The location was perfect - within walking distance to all the shops and restaurants.	comment
en-development-0358	also this is not a destination for a solo traveler.	comment, complaint
en-development-0359	Let's just say this game has hidden depths.	comment
en-development-0360	Staff is very friendly and supportive.	comment
en-development-0361	Did people's reviews get deleted or something when you updated the versions?	request
en-development-0362	The rooms were all commodious and the staff was courteous and responsive.	comment
en-development-0363	and its so fun	comment
en-development-0364	Beautiful afternoon at the Bristol!	meaningless
en-development-0365	is great	comment
en-development-0366	Mzeye and has a distinct, very sweet	meaningless
en-development-0367	My husband and I choose this beautiful hotel for its location, price, and style.	comment
en-development-0368	Need to kwno which all programming languages i need to know to start working on Android SDK?	meaningless
en-development-0369	This app is stopping unfortunately in every 5 minutes....	bug
en-development-0370	nice tool!	comment
en-development-0371	I would love to buy and download music on my pc I do not know much about	comment
en-development-0372	I just wanna stay here again because it was marvelous hotel.	comment
en-development-0373	This is an absolutely great casual game!	comment
en-development-0374	We booked a King size room, at check-in we've been told King Size room are all occupied (a lie because later I realized that resort was not fully booked) and receptionist tried to bargain with us for a single beds room.	complaint
en-development-0375	not for other games	comment
en-development-0376	I have a slight mobility problem and this was as comfortable and easy as it gets.	comment
en-development-0377	I spent a whole day trying to get my 8Gig iTouch to give up all the images I had saved from the internet.	complaint
en-development-0378	The latest version does not allow this or there is no option.	undefined
en-development-0379	Very awful new look and inefficient app.	complaint
en-development-0380	Not sure why this is happening.	comment
en-development-0381	Waste of space	complaint
en-development-0382	There are few pictures need to be better and make sense to the words because there are deaf people who like to play this game and it is hard for them to sound the words.	complaint, request
en-development-0383	Edit: after using it for a couple of hours I've realized that it's also super slow, so that's a great update, isn't it?	complaint
en-development-0384	Notifications button only shows People I may know NOT actual notification.	bug
en-development-0385	I suggest to move this programs from that part to main pool to give this possibility to all the guests to join them not just for persons .	complaint
en-development-0386	When I select a live stream on the tv, it shows the channel selected.	comment
en-development-0387	But That Old Version Will Not Play The New H.264 Format,	complaint
en-development-0388	I can't say enough about this place!	comment
en-development-0389	but please, PLEASE allow there to be an option to toggle the online/offline statuses back on, or SOMETHING.	request, complaint
en-development-0390	Nothing, it was perfect!	comment
en-development-0391	The rooms are spotlessly clean and tastefully decorated.	comment
en-development-0392	Nothing seems to have been addressed on these matters that people have been complaining about since the app came out either.	complaint
en-development-0393	Expensive for what you get.	complaint
en-development-0394	This is a serious problem which the management needs to review and improve immediately.	complaint
en-development-0395	This is poor as hotels are not cheap & paring for guests should be free.	complaint
en-development-0396	Mga SubskripsiyonView	meaningless
en-development-0397	Also the whole room was soaking wet all the time all our clothes were wet and everything in the room we touched was soaking well the room was freezing we turned it off but it would come back on again that couldn't have been healthy for us at our age.	complaint
en-development-0398	Bring back Invisible and Away!	request
en-development-0399	Ok, it's better if you know a bit about what you're doing first, but with a bit of research and a bit of trial and error, I've been coming up with Great HD rips from Blu-Ray.	comment
en-development-0400	Adobe's Flash Player is so ingrained the WEB that most sites will 'flash' you a message that you don't have Flash installed.	comment
en-development-0401	Other than that this is a great app	comment
en-development-0402	This game is the best game i have everseen.	comment
en-development-0403	I would appreciate any kind of help.	request
en-development-0404	Stunningly good.	comment
en-development-0405	We booked this hotel as it's part of SLH and we where never disappointed .	comment
en-development-0406	This is not the latest version!	complaint
en-development-0407	Some of the filter like eye color, lipstick, hair color are very tough to apply, so a focus on that can be made ao that these filters are applied easily.	complaint
en-development-0408	Buses full of tourists come and go.	comment
en-development-0409	Not enough fresh fruit on offer for breakfast nor yogurts.	complaint
en-development-0410	This is a clean, comfortable room with good breakfast and the staff also very nice.	comment
en-development-0411	The rooms are modern and comfortable.	comment
en-development-0412	Very rude staff in the reception and not helpful when we asked for use the hotel's services.	complaint
en-development-0413	Let us choose the default order.	request
en-development-0414	feels some graphic issues..	complaint
en-development-0415	Staff especially the Events manager where very nice	comment
en-development-0416	After we refuse for obvious reason, they bring in another fridge and place it on the floor as on the photo, which is truly hilarious for a 5 star resort.	complaint
en-development-0417	Many OH &S issues accessing the beach whist construction happening!	complaint
en-development-0418	Incompatible with ClassicShell releases, freezes continuously, has horrible graphics and it is full of bugs.	complaint, bug
en-development-0419	this app saves me 39 euro when i had my ticket just on my phone that mashine refuse to accept it so a one of the crew help me to download this ap and show me how can i get a completely different code and it work :D	comment
en-development-0420	Room a bit old.	complaint
en-development-0421	Too MANY ADS	complaint
en-development-0422	Works straight out of the box	comment
en-development-0423	its cool and awsome i love it	comment
en-development-0424	I didn't like we didn't get told about the front pool being closed and the restaurant.	complaint
en-development-0425	This review doesn't tell the whole story.	complaint
en-development-0426	- The bedroom was recommended 2 adults+2 Kids, however the bed-sofa fits just one Person - which was not informed before;	complaint
en-development-0427	The concierge was super helpful ...	comment
en-development-0428	That's really pathetic cause those are the languages I want & are spoken by 100s of millions of people.	complaint
en-development-0429	In all reality, it is a glorified version of	meaningless
en-development-0430	Every question that we had for the Concierge was answered or fulfilled immediately and without hesitation.	comment
en-development-0431	is amayzing :D and is really really really awsome	comment
en-development-0432	So, he was also limited about the good spot recommendations & overall advices.	complaint
en-development-0433	Pool Access Room was a long walk from the lobby.	complaint
en-development-0434	Only the fact that the beach bar & pool had started to be demolished the week before we arrived.	complaint
en-development-0435	Steals Your money.	complaint
en-development-0436	Hello sir i need to transfer $ 9.million us dollars to you i am chinyere sonia ayozie from sierra leone	comment
en-development-0437	but we loved our stay and will be back!	comment
en-development-0438	Not a long enough stay to see the wonderful coastal area	comment
en-development-0439	Once you put your info ie. shipping and billing info you dont have to do it for every order l just tap buy choose size and swipe to confirm very simple.	comment
en-development-0440	I only wish I would have stayed in this hotel my entire trip.	comment
en-development-0441	- records sounds from soft and/or mic	comment
en-development-0442	Being able to communicate with a person in their native language, even with imperfect grammar helps bridge the gap between parties of dissimilar origin.	comment
en-development-0443	When myself or my business is included in one of these posts I would love to be able to repost and credit the source without having to screenshot or screen record their original post.	request
en-development-0444	Unbelievable trash!	complaint
en-development-0445	A beautifully crafted boutique resort.	comment
en-development-0446	Normal game!	comment
en-development-0447	When it comes to the end like a minute or so until it ends it just stops with an error message giving options such as cancel or more details.	bug
en-development-0448	My mom and I stayed here for a week for spring break and loved it.	comment
en-development-0449	I use it everytime I needed to edit a photo, but now it crashes when using makeuptool.	bug
en-development-0450	The breakfast buffet was a great deal at 12 euros.	comment
en-development-0451	We are so lucky to have found the perfect second home at the heart of Paris.	comment
en-development-0452	Service : excellent	comment
en-development-0453	My husband and I stayed at Casa Camper for two nights prior to a cruise.	meaningless
en-development-0454	The Best Thing Has Always Been How You	meaningless
en-development-0455	The mattress was way too firm and the pillow had no "bounce" at all.	complaint
en-development-0456	It crashed two of my hard drives.	bug
en-development-0457	Nearly 33 GB and only took about 70mins.	comment
en-development-0458	Absolutely fantastic.	comment
en-development-0459	It is easy to figure out how to use	comment
en-development-0460	Fantastic room on the 5th floor.	comment
en-development-0461	I have searched for so many accounting software.	comment
en-development-0462	The bed was hard as a rock.	complaint
en-development-0463	This product is awesome it picks up malware in a click of a finger.	comment
en-development-0464	Recommend it to everyone for keeping and organizing ideas.	comment
en-development-0465	EDIT: I love how quickly the developers fixed the issue and the great considerate support they gave.	comment
en-development-0466	When you get to their site it's confusing and unclear.	complaint
en-development-0467	Hotel policies must be reviewed to create a good ambience and not to on poor quality tourism.	complaint
en-development-0468	Love it!!!	comment
en-development-0469	During off-season (now) a lot of things aren't there even if advertised.	complaint
en-development-0470	Excelent!	comment
en-development-0471	Nice residential neighborhood.	comment
en-development-0472	Reception not very helpfull on this occasion	complaint
en-development-0473	I really like the program, but I do have a big objection, and a second that is due to the first.	comment, complaint
en-development-0474	It was right in the center of Nice and close to absolutely everything.	comment
en-development-0475	Amazing view across the harbour from the roof terrace which has sun beds and a small plunge pool.	comment
en-development-0476	I felt the food quality/taste could have been better, check-in could have been better organized (took a while to find my bookings, as I had 2 separate ones.. then directed to the Club for check-in where the same thing happened! Then somehow it was reflected I didn't turn up for my booking so I was told I needed to be charged after I left)	complaint
en-development-0477	Also it keeps making itself default browser.	complaint
en-development-0478	Its the bt game in the world/Beer than all GTA's.	comment
en-development-0479	Over the years I have had too many disappointments with so called professional reviews.	meaningless
en-development-0480	Join "BITURO" App referral : (TRSLA) for get 50 FreeGiftzCard cashinstall APPKARMA App r e f e r : (us14) get 50 FreeGiftzCard cash Honest app The are only a few apps that arelegitimate.	meaningless
en-development-0481	Great service and location, being down the road from the Louvre, a very short stroll to the Seine, across the bridge from the Italian section.	comment
en-development-0482	The staff were good behaving.	comment
en-development-0483	Its s fun app, but i cant really use it :(	comment, complaint
en-development-0484	Thank you!	comment
en-development-0485	I installed thiamine app 20 minutes ago and haven't stopped playing yet....	comment
en-development-0486	The check-in clerk was super friendly!	comment
en-development-0487	It is not working on Windows 8 however I clicked it many times	bug
en-development-0488	No Chromecast support , mandatory adverts.	complaint
en-development-0489	good time consumer.	comment
en-development-0490	It is a really awesome good game.	comment
en-development-0491	a action pack/ adventure hardcore zombie killing game	comment
en-development-0492	great game and the best game too	comment
en-development-0493	Keeps saying "17/06/2014 16:09:43 : Exception - Can't Identify OS version"	bug
en-development-0494	Please make this game for mac!	request
en-development-0495	Also, couldn't figure out the temperature control to make the room cooler.	complaint
en-development-0496	DJä-MIXXER is very nice	meaningless
en-development-0497	Stay at this hotel Monday thru to Friday and what a find, a welcome drink on arrival set this stay of to a great start.	comment
en-development-0498	The location is fantastic, and the hotel services speak for themselves.	comment
en-development-0499	provide a app that can work on Samsung smart TV nor on Chromecast would have given one, but there are some nice series available.	meaningless
en-development-0500	The minute it starts to boot up, it crashes, every time.	bug

